8 8 8 8 8 8 8 8 8 8 8 8 8 8 8 8
7 7 7 4 5 3 7 7 7 7 7 7 3 7 7 7
6 6 6 6 6 2 6 6 6 6 6 6 2 6 6 6
0 0 0 0 0 0 0 0 0 0 0 0 0 0 0 0
0 0 0 0 0 0 0 0 0 0 0 0 0 0 0 0
0 0 0 0 0 0 0 0 0 0 0 9 9 9 9 9
0 0 0 0 0 0 0 0 0 0 0 9 9 9 9 9
0 0 0 0 0 0 0 0 0 0 0 12 8 8 8 8
0 0 0 0 0 0 0 0 0 0 0 11 7 3 7 7
0 0 0 0 0 0 0 0 0 0 0 10 6 2 6 6
0 0 0 0 0 0 0 0 0 0 0 0 0 0 0 0
0 0 0 0 0 0 0 0 0 0 0 0 0 0 0 0